_strlwr				char * (__cdecl *_strlwr)(char *str)
_strset				char * (__cdecl *_strset)(char *str, int c)
_strupr				char * (__cdecl *_strupr)(char *str)
AdjustTokenPrivileges		BOOL (__stdcall *AdjustTokenPrivileges)(HANDLE TokenHandle, BOOL DisableAllPrivileges, PTOKEN_PRIVILEGES NewState, DWORD BufferLength, PTOKEN_PRIVILEGES PreviousState, PDWORD ReturnLength)
bind				int (__stdcall *bind)(SOCKET s, const sockaddr *addr, int namelen)
capCreateCaptureWindowA		HWND (__stdcall *capCreateCaptureWindowA)(LPCSTR lpszWindowName, DWORD dwStyle, int x, int y, int nWidth, int nHeight, HWND hwndParent, int nID)
capCreateCaptureWindowW		HWND (__stdcall *capCreateCaptureWindowW)(LPCWSTR lpszWindowName, DWORD dwStyle, int x, int y, int nWidth, int nHeight, HWND hwndParent, int nID)
capGetDriverDescriptionA	BOOL (__stdcall *capGetDriverDescriptionA)(UINT wDriverIndex, LPSTR lpszName, int cbName, LPSTR lpszVer, int cbVer)
capGetDriverDescriptionW	BOOL (__stdcall *capGetDriverDescriptionA)(UINT wDriverIndex, LPWSTR lpszName, int cbName, LPWSTR lpszVer, int cbVer)
CloseHandle			BOOL (__stdcall *CloseHandle)(HANDLE hObject)
closesocket			int (__stdcall *closesocket)(SOCKET s)
CoCreateGuid			HRESULT (__stdcall *CoCreateGuid)(GUID* pguid)
CoInitialize			HRESULT (__stdcall *CoInitialize)(LPVOID pvReserved)
connect				int (__stdcall *connect)(SOCKET s, const sockaddr *name, int namelen)
CoUninitialize			void (__stdcall *CoUninitialize)()
CreateDirectoryA		BOOL (__stdcall *CreateDirectoryA)(LPCSTR lpPathName, LPSECURITY_ATTRIBUTES lpSecurityAttributes)
CreateDirectoryW		BOOL (__stdcall *CreateDirectoryW)(LPCWSTR lpPathName, LPSECURITY_ATTRIBUTES lpSecurityAttributes)
CreateEventA			HANDLE (__stdcall *CreateEventA)(LPSECURITY_ATTRIBUTES lpEventAttributes, BOOL bManualReset, BOOL bInitialState, LPCSTR lpName)
CreateEventW			HANDLE (__stdcall *CreateEventW)(LPSECURITY_ATTRIBUTES lpEventAttributes, BOOL bManualReset, BOOL bInitialState, LPCWSTR lpName)
CreateFileA			HANDLE (__stdcall *CreateFileA)(LPCSTR lpFileName, DWORD dwDesiredAccess, DWORD dwShareMode, LPSECURITY_ATTRIBUTES lpSecurityAttributes, DWORD dwCreationDisposition, DWORD dwFlagsAndAttributes, HANDLE hTemplateFile)
CreateFileW			HANDLE (__stdcall *CreateFileW)(LPCWSTR lpFileName, DWORD dwDesiredAccess, DWORD dwShareMode, LPSECURITY_ATTRIBUTES lpSecurityAttributes, DWORD dwCreationDisposition, DWORD dwFlagsAndAttributes, HANDLE hTemplateFile)
CreateIoCompletionPort		HANDLE (__stdcall *CreateIoCompletionPort)(HANDLE FileHandle, HANDLE ExistingCompletionPort, ULONG_PTR CompletionKey, DWORD NumberOfConcurrentThreads)
CreateMutexA			HANDLE (__stdcall *CreateMutexA)(LPSECURITY_ATTRIBUTES lpMutexAttributes, BOOL bInitialOwner, LPCSTR lpName)
CreateMutexW			HANDLE (__stdcall *CreateMutexW)(LPSECURITY_ATTRIBUTES lpMutexAttributes, BOOL bInitialOwner, LPCWSTR lpName)
CreatePipe			BOOL (__stdcall *CreatePipe)(PHANDLE hReadPipe, PHANDLE hWritePipe, LPSECURITY_ATTRIBUTES lpPipeAttributes, DWORD nSize)
CreateProcessA			BOOL (__stdcall *CreateProcessA)(LPCSTR lpApplicationName, LPSTR lpCommandLine, LPSECURITY_ATTRIBUTES lpProcessAttributes, LPSECURITY_ATTRIBUTES lpThreadAttributes, BOOL bInheritHandles, DWORD dwCreationFlags, LPVOID lpEnvironment, LPCSTR lpCurrentDirectory, LPSTARTUPINFOA lpStartupInfo, LPPROCESS_INFORMATION lpProcessInformation)
CreateProcessAsUserA		BOOL (__stdcall *CreateProcessAsUserA)(HANDLE hToken, LPCSTR lpApplicationName, LPSTR lpCommandLine, LPSECURITY_ATTRIBUTES lpProcessAttributes, LPSECURITY_ATTRIBUTES lpThreadAttributes, BOOL bInheritHandles, DWORD dwCreationFlags, LPVOID lpEnvironment, LPCSTR lpCurrentDirectory, LPSTARTUPINFOA lpStartupInfo, LPPROCESS_INFORMATION lpProcessInformation)
CreateProcessAsUserW		BOOL (__stdcall *CreateProcessAsUserW)(HANDLE hToken, LPCWSTR lpApplicationName, LPWSTR lpCommandLine, LPSECURITY_ATTRIBUTES lpProcessAttributes, LPSECURITY_ATTRIBUTES lpThreadAttributes, BOOL bInheritHandles, DWORD dwCreationFlags, LPVOID lpEnvironment, LPCWSTR lpCurrentDirectory, LPSTARTUPINFOW lpStartupInfo, LPPROCESS_INFORMATION lpProcessInformation)
CreateProcessW			BOOL (__stdcall *CreateProcessW)(LPCWSTR lpApplicationName, LPWSTR lpCommandLine, LPSECURITY_ATTRIBUTES lpProcessAttributes, LPSECURITY_ATTRIBUTES lpThreadAttributes, BOOL bInheritHandles, DWORD dwCreationFlags, LPVOID lpEnvironment, LPCWSTR lpCurrentDirectory, LPSTARTUPINFOW lpStartupInfo, LPPROCESS_INFORMATION lpProcessInformation)
CreateThread			HANDLE (__stdcall *CreateThread)(LPSECURITY_ATTRIBUTES lpThreadAttributes, SIZE_T dwStackSize, LPTHREAD_START_ROUTINE lpStartAddress, LPVOID lpParameter, DWORD dwCreationFlags, LPDWORD lpThreadId)
CreateToolhelp32Snapshot	HANDLE (__stdcall *CreateToolhelp32Snapshot)(DWORD dwFlags, DWORD th32ProcessID)
CredEnumerateA			BOOL (__stdcall *CredEnumerateA)(LPCSTR Filter, DWORD Flags, DWORD *Count,PCREDENTIALA **Credential)
CredEnumerateW			BOOL (__stdcall *CredEnumerateW)(LPCWSTR Filter, DWORD Flags, DWORD *Count, PCREDENTIALW **Credential)
CredFree			void (__stdcall *CredFree)(PVOID Buffer)
CryptAcquireContextA		BOOL (__stdcall *CryptAcquireContextA)(HCRYPTPROV *phProv, LPCSTR szContainer, LPCSTR szProvider, DWORD dwProvType, DWORD dwFlags)
CryptAcquireContextW		BOOL (__stdcall *CryptAcquireContextW)(HCRYPTPROV *phProv, LPCWSTR szContainer, LPCWSTR szProvider, DWORD dwProvType, DWORD dwFlags)
CryptCreateHash			BOOL (__stdcall *CryptCreateHash)(HCRYPTPROV hProv, ALG_ID Algid, HCRYPTKEY hKey, DWORD dwFlags, HCRYPTHASH *phHash)
CryptDestroyHash		BOOL (__stdcall *CryptDestroyHash)(HCRYPTHASH hHash)
CryptGetHashParam		BOOL (__stdcall *CryptGetHashParam)(HCRYPTHASH hHash, DWORD dwParam, BYTE *pbData, DWORD *pdwDataLen, DWORD dwFlags)
CryptHashData			BOOL (__stdcall *CryptHashData)(HCRYPTHASH hHash, const BYTE *pbData, DWORD dwDataLen, DWORD dwFlags)
CryptReleaseContext		BOOL (__stdcall *CryptReleaseContext)(HCRYPTPROV hProv, DWORD dwFlags)
CryptUnprotectData		BOOL (__stdcall *CryptUnprotectData)(DATA_BLOB *pDataIn, LPWSTR *ppszDataDescr, DATA_BLOB *pOptionalEntropy, PVOID pvReserved, CRYPTPROTECT_PROMPTSTRUCT *pPromptStruct, DWORD dwFlags, DATA_BLOB *pDataOut)
DeleteCriticalSection		void (__stdcall *DeleteCriticalSection)(LPCRITICAL_SECTION lpCriticalSection)
DeleteFileA			BOOL (__stdcall *DeleteFileA)(LPCSTR lpFileName)
DuplicateHandle			BOOL (__stdcall *DuplicateHandle)(HANDLE hSourceProcessHandle, HANDLE hSourceHandle, HANDLE hTargetProcessHandle, LPHANDLE lpTargetHandle, DWORD dwDesiredAccess, BOOL bInheritHandle, DWORD dwOptions)
EnterCriticalSection		void (__stdcall *EnterCriticalSection)(LPCRITICAL_SECTION lpCriticalSection)
EnumProcessModules		BOOL (__stdcall *EnumProcessModules)(HANDLE hProcess, HMODULE *lphModule, DWORD cb, LPDWORD lpcbNeeded)
EnumServicesStatusExW		BOOL (__stdcall *EnumServicesStatusExW)(SC_HANDLE hSCManager, SC_ENUM_TYPE InfoLevel, DWORD dwServiceType, DWORD dwServiceState, LPBYTE lpServices, DWORD cbBufSize, LPDWORD pcbBytesNeeded, LPDWORD lpServicesReturned, LPDWORD lpResumeHandle, LPCWSTR pszGroupName)
FindClose			BOOL (__stdcall *FindClose)(HANDLE hFindFile)
FindFirstFileA			HANDLE (__stdcall *FindFirstFileA)(LPCSTR lpFileName, LPWIN32_FIND_DATAA lpFindFileData)
FindNextFileA			BOOL (__stdcall *FindNextFileA)(HANDLE hFindFile, LPWIN32_FIND_DATAA lpFindFileData)
free				void (__cdecl *free)(void *memblock)
GetComputerNameA		BOOL (__stdcall *GetComputerNameA)(LPSTR lpBuffer, LPDWORD nSize)
GetComputerNameW		BOOL (__stdcall *GetComputerNameW)(LPWSTR lpBuffer, LPDWORD nSize)
GetCurrentProcess		HANDLE (__stdcall *GetCurrentProcess)()
GetCurrentProcessId		DWORD (__stdcall *GetCurrentProcessId)()
GetDriveTypeA			UINT (__stdcall *GetDriveTypeA)(LPCSTR lpRootPathName)
GetDriveTypeW			UINT (__stdcall *GetDriveTypeW)(LPCWSTR lpRootPathName)
GetExitCodeProcess		BOOL (__stdcall *GetExitCodeProcess)(HANDLE  hProcess, LPDWORD lpExitCode)
GetExitCodeThread		BOOL (__stdcall *GetExitCodeThread)(HANDLE hThread, LPDWORD lpExitCode)
GetFileAttributesA		DWORD (__stdcall *GetFileAttributesA)(LPCSTR lpFileName)
GetFileAttributesW		DWORD (__stdcall *GetFileAttributesW)(LPCWSTR lpFileName)
GetFileSize			DWORD (__stdcall *GetFileSize)(HANDLE  hFile, LPDWORD lpFileSizeHigh)
GetFileTime			BOOL (__stdcall *GetFileTime)(HANDLE hFile, LPFILETIME lpCreationTime, LPFILETIME lpLastAccessTime, LPFILETIME lpLastWriteTime)
gethostbyname			hostent * (__stdcall *gethostbyname)(const char *name)
gethostname			int (__stdcall *gethostname)(char *name, int namelen)
GetLastError			DWORD (__stdcall *GetLastError)()
GetLongPathNameA		DWORD (__stdcall *GetLongPathNameA)(LPCSTR lpszShortPath, LPSTR lpszLongPath, DWORD cchBuffer)
GetLongPathNameW		DWORD (__stdcall *GetLongPathNameW)(LPCWSTR lpszShortPath, LPWSTR lpszLongPath, DWORD cchBuffer)
GetModuleFileNameA		DWORD (__stdcall *GetModuleFileNameA)(HMODULE hModule, LPSTR lpFilename, DWORD nSize)
GetModuleFileNameExA		DWORD (__stdcall *GetModuleFileNameExA)(HANDLE hProcess, HMODULE hModule, LPSTR lpFilename, DWORD nSize)
GetModuleFileNameExW		DWORD (__stdcall *GetModuleFileNameExW)(HANDLE hProcess, HMODULE hModule, LPWSTR lpFilename, DWORD nSize)
GetModuleFileNameW		DWORD (__stdcall *GetModuleFileNameW)(HMODULE hModule, LPWSTR lpFilename, DWORD nSize)
GetModuleHandleA		HMODULE (__stdcall *GetModuleHandleA)(LPCSTR lpModuleName)
GetModuleHandleW		HMODULE (__stdcall *GetModuleHandleW)(LPCWSTR lpModuleName)
GetProcAddress			FARPROC (__stdcall *GetProcAddress)(HMODULE hModule, LPCSTR lpProcName)
GetQueuedCompletionStatus	BOOL (__stdcall *GetQueuedCompletionStatus)(HANDLE CompletionPort, LPDWORD lpNumberOfBytesTransferred, PULONG_PTR lpCompletionKey, LPOVERLAPPED *lpOverlapped, DWORD dwMilliseconds)
GetShortPathNameA		DWORD (__stdcall *GetShortPathNameA)(LPCSTR lpszLongPath, LPSTR lpszShortPath, DWORD cchBuffer)
getsockname			int (__stdcall *getsockname)(SOCKET s, sockaddr *name, int *namelen)
GetStartupInfoA			void (__stdcall *GetStartupInfoA)(LPSTARTUPINFOA lpStartupInfo)
GetStartupInfoW			void (__stdcall *GetStartupInfoW)(LPSTARTUPINFOW lpStartupInfo)
GetSystemDirectoryA		UINT (__stdcall *GetSystemDirectoryA)(LPSTR lpBuffer, UINT uSize)
GetSystemDirectoryW		UINT (__stdcall *GetSystemDirectoryW)(LPWSTR lpBuffer, UINT uSize)
GetSystemInfo			void (__stdcall *GetSystemInfo)(LPSYSTEM_INFO lpSystemInfo)
GetSystemTime			void (__stdcall *GetSystemTime)(LPSYSTEMTIME lpSystemTime)
GetSystemTimeAsFileTime		void (__stdcall *GetSystemTimeAsFileTime)(LPFILETIME lpSystemTimeAsFileTime)
GetTempPathA			DWORD (__stdcall *GetTempPathA)(DWORD nBufferLength, LPSTR lpBuffer)
GetTempPathW			DWORD (__stdcall *GetTempPathW)(DWORD  nBufferLength, LPWSTR lpBuffer)
GetTickCount			DWORD (__stdcall *GetTickCount)()
GetUserNameA			BOOL (__stdcall *GetUserNameA)(LPSTR lpBuffer, LPDWORD pcbBuffer)
GetUserNameW			BOOL (__stdcall *GetUserNameW)(LPWSTR lpBuffer, LPDWORD pcbBuffer)
GetVolumeInformationA		BOOL (__stdcall *GetVolumeInformationA)(LPCSTR lpRootPathName, LPSTR lpVolumeNameBuffer, DWORD nVolumeNameSize, LPDWORD lpVolumeSerialNumber, LPDWORD lpMaximumComponentLength, LPDWORD lpFileSystemFlags, LPSTR lpFileSystemNameBuffer, DWORD nFileSystemNameSize)
GetVolumeInformationW		BOOL (__stdcall *GetVolumeInformationW)(LPCWSTR lpRootPathName, LPWSTR lpVolumeNameBuffer, DWORD nVolumeNameSize, LPDWORD lpVolumeSerialNumber, LPDWORD lpMaximumComponentLength, LPDWORD lpFileSystemFlags, LPWSTR lpFileSystemNameBuffer, DWORD nFileSystemNameSize)
GetWindowsDirectoryA		UINT (__stdcall *GetWindowsDirectoryA)(LPSTR lpBuffer, UINT uSize)
GetWindowsDirectoryW		UINT (__stdcall *GetWindowsDirectoryW)(LPWSTR lpBuffer, UINT uSize)
htons				u_short (__stdcall *htons)(u_short hostshort)
ILFree				void (__stdcall *ILFree)(void *pidl)
inet_addr			unsigned long (__stdcall *inet_addr)(const char *cp)
inet_ntoa			char * (__stdcall *inet_ntoa)(in_addr in)
InitializeCriticalSection	void (__stdcall *InitializeCriticalSection)(LPCRITICAL_SECTION lpCriticalSection)
LeaveCriticalSection		void (__stdcall *LeaveCriticalSection)(LPCRITICAL_SECTION lpCriticalSection)
LoadLibraryA			HMODULE (__stdcall *LoadLibraryA)(LPCSTR lpLibFileName)
LoadLibraryW			HMODULE (__stdcall *LoadLibraryW)(LPCWSTR lpLibFileName)
LookupPrivilegeValueA		BOOL (__stdcall *LookupPrivilegeValueA)(LPCSTR lpSystemName, LPCSTR lpName, PLUID lpLuid)
LookupPrivilegeValueW		BOOL (__stdcall *LookupPrivilegeValueW)(LPCWSTR lpSystemName, LPCWSTR lpName, PLUID lpLuid)
lstrcatA			LPSTR (__stdcall *lstrcatA)(LPSTR lpString1, LPCSTR lpString2)
lstrcatW			LPWSTR (__stdcall *lstrcatW)(LPWSTR lpString1, LPCWSTR lpString2)
lstrcmpiA			int (__stdcall *lstrcmpiA)(LPCSTR lpString1, LPCSTR lpString2)
lstrcmpiW			int (__stdcall *lstrcmpiW)(LPCWSTR lpString1, LPCWSTR lpString2)
lstrcpyA			LPSTR (__stdcall *lstrcpyA)(LPSTR lpString1, LPCSTR lpString2)
lstrcpyW			LPWSTR (__stdcall *lstrcpyW)(LPWSTR lpString1, LPCWSTR lpString2)
lstrlenA			int (__stdcall *lstrlenA)(LPCSTR lpString)
lstrlenW			int (__stdcall *lstrlenW)(LPCWSTR lpString)
malloc				void * (__cdecl *malloc)(size_t size)
memcmp				int (__cdecl *memcmp)(const void *buffer1, const void *buffer2, size_t count)
memcpy				void * (__cdecl *memcpy)(void *dest, const void *src, size_t count)
memset				void * (__cdecl *memset)(void *dest, int c, size_t count)
MultiByteToWideChar		int (__stdcall *MultiByteToWideChar)(UINT CodePage, DWORD dwFlags, LPCCH lpMultiByteStr, int cbMultiByte, LPWSTR lpWideCharStr, int cchWideChar)
ntohs				u_short (__stdcall *ntohs)(u_short netshort)
OpenEventA			HANDLE (__stdcall *OpenEventA)(DWORD dwDesiredAccess, BOOL bInheritHandle, LPCSTR lpName)
OpenEventW			HANDLE (__stdcall *OpenEventW)(DWORD dwDesiredAccess, BOOL bInheritHandle, LPCWSTR lpName)
OpenProcess			HANDLE (__stdcall *OpenProcess)(DWORD dwDesiredAccess, BOOL bInheritHandle, DWORD dwProcessId)
OpenProcessToken		BOOL (__stdcall *OpenProcessToken)(HANDLE ProcessHandle, DWORD DesiredAccess, PHANDLE TokenHandle)
PeekNamedPipe			BOOL (__stdcall *PeekNamedPipe)(HANDLE hNamedPipe, LPVOID lpBuffer, DWORD nBufferSize, LPDWORD lpBytesRead, LPDWORD lpTotalBytesAvail, LPDWORD lpBytesLeftThisMessage)
PostQueuedCompletionStatus	BOOL (__stdcall *PostQueuedCompletionStatus)(HANDLE CompletionPort, DWORD dwNumberOfBytesTransferred, ULONG_PTR dwCompletionKey, LPOVERLAPPED lpOverlapped)
pow				double (__cdecl *pow)(double x, double y)
Process32First			BOOL (__stdcall *Process32First)(HANDLE hSnapshot, LPPROCESSENTRY32 lppe)
Process32Next			BOOL (__stdcall *Process32Next)(HANDLE hSnapshot, LPPROCESSENTRY32 lppe)
rand				int (__cdecl *rand)(void)
ReadFile			BOOL (__stdcall *ReadFile)(HANDLE hFile, LPVOID lpBuffer, DWORD nNumberOfBytesToRead, LPDWORD lpNumberOfBytesRead, LPOVERLAPPED lpOverlapped)
ReadProcessMemory		BOOL (__stdcall *ReadProcessMemory)(HANDLE hProcess, LPCVOID lpBaseAddress, LPVOID lpBuffer, SIZE_T nSize, SIZE_T *lpNumberOfBytesRead)
recv				int (__stdcall *recv)(SOCKET s, char *buf, int len, int flags)
recvfrom			int (__stdcall *recvfrom)(SOCKET s, char *buf, int len, int flags, sockaddr *from, int *fromlen)
RegCloseKey			LSTATUS (__stdcall *RegCloseKey)(HKEY hKey)
RegCreateKeyA			LSTATUS (__stdcall *RegCreateKeyA)(HKEY hKey, LPCSTR lpSubKey, PHKEY phkResult)
RegCreateKeyExA			LSTATUS (__stdcall *RegCreateKeyExA)(HKEY hKey, LPCSTR lpSubKey, DWORD Reserved, LPSTR lpClass, DWORD dwOptions, REGSAM samDesired, const LPSECURITY_ATTRIBUTES lpSecurityAttributes, PHKEY phkResult, LPDWORD lpdwDisposition)
RegCreateKeyExW			LSTATUS (__stdcall *RegCreateKeyExW)(HKEY hKey, LPCWSTR lpSubKey, DWORD Reserved, LPWSTR lpClass, DWORD dwOptions, REGSAM samDesired, const LPSECURITY_ATTRIBUTES lpSecurityAttributes, PHKEY phkResult, LPDWORD lpdwDisposition)
RegCreateKeyW			LSTATUS (__stdcall *RegCreateKeyW)(HKEY hKey, LPCWSTR lpSubKey, PHKEY phkResult)
RegEnumValueA			LSTATUS (__stdcall *RegEnumValueA)(HKEY hKey, DWORD dwIndex, LPSTR lpValueName, LPDWORD lpcchValueName, LPDWORD lpReserved, LPDWORD lpType, LPBYTE lpData, LPDWORD lpcbData)
RegEnumValueW			LSTATUS (__stdcall *RegEnumValueW)(HKEY hKey, DWORD dwIndex, LPWSTR lpValueName, LPDWORD lpcchValueName, LPDWORD lpReserved, LPDWORD lpType, LPBYTE lpData, LPDWORD lpcbData)
RegOpenKeyExA			LSTATUS (__stdcall *RegOpenKeyExA)(HKEY hKey, LPCSTR lpSubKey, DWORD ulOptions, REGSAM samDesired, PHKEY phkResult)
RegOpenKeyExW			LSTATUS (__stdcall *RegOpenKeyExW)(HKEY hKey, LPCWSTR lpSubKey, DWORD ulOptions, REGSAM samDesired, PHKEY phkResult)
RegQueryInfoKeyA		LSTATUS (__stdcall *RegQueryInfoKeyA)(HKEY hKey, LPSTR lpClass, LPDWORD lpcchClass, LPDWORD lpReserved, LPDWORD lpcSubKeys, LPDWORD lpcbMaxSubKeyLen, LPDWORD lpcbMaxClassLen, LPDWORD lpcValues, LPDWORD lpcbMaxValueNameLen, LPDWORD lpcbMaxValueLen, LPDWORD lpcbSecurityDescriptor, PFILETIME lpftLastWriteTime)
RegQueryInfoKeyW		LSTATUS (__stdcall *RegQueryInfoKeyW)(HKEY hKey, LPWSTR lpClass, LPDWORD lpcchClass, LPDWORD lpReserved, LPDWORD lpcSubKeys, LPDWORD lpcbMaxSubKeyLen, LPDWORD lpcbMaxClassLen, LPDWORD lpcValues, LPDWORD lpcbMaxValueNameLen, LPDWORD lpcbMaxValueLen, LPDWORD lpcbSecurityDescriptor, PFILETIME lpftLastWriteTime)
RegQueryValueExA		LSTATUS (__stdcall *RegQueryValueExA)(HKEY hKey, LPCSTR lpValueName, LPDWORD lpReserved, LPDWORD lpType, LPBYTE lpData, LPDWORD lpcbData)
RegQueryValueExW		LSTATUS (__stdcall *RegQueryValueExW)(HKEY hKey, LPCWSTR lpValueName, LPDWORD lpReserved, LPDWORD lpType, LPBYTE lpData, LPDWORD lpcbData)
RegSetValueExA			LSTATUS (__stdcall *RegSetValueExA)(HKEY hKey, LPCSTR lpValueName, DWORD Reserved, DWORD dwType, const BYTE *lpData, DWORD cbData)
RegSetValueExW			LSTATUS (__stdcall *RegSetValueExW)(HKEY hKey, LPCWSTR lpValueName, DWORD Reserved, DWORD dwType, const BYTE *lpData, DWORD cbData)
ResetEvent			BOOL (__stdcall *ResetEvent)(HANDLE hEvent)
send				int (__stdcall *send)(SOCKET s, const char *buf, int len, int flags)
sendto				int (__stdcall *sendto)(SOCKET s, const char *buf, int len, int flags, const sockaddr *to, int tolen)
SetEvent			BOOL (__stdcall *SetEvent)(HANDLE hEvent)
SetFileAttributesA		BOOL (__stdcall *SetFileAttributesA)(LPCSTR lpFileName, DWORD dwFileAttributes)
SetFileAttributesW		BOOL (__stdcall *SetFileAttributesW)(LPCWSTR lpFileName, DWORD dwFileAttributes)
SetFilePointer			DWORD (__stdcall *SetFilePointer)(HANDLE hFile, LONG lDistanceToMove, PLONG lpDistanceToMoveHigh, DWORD dwMoveMethod)
SetFilePointerEx		BOOL (__stdcall *SetFilePointerEx)(HANDLE hFile, LARGE_INTEGER liDistanceToMove, PLARGE_INTEGER lpNewFilePointer, DWORD dwMoveMethod)
SetFileTime			BOOL (__stdcall *SetFileTime)(HANDLE hFile, const FILETIME *lpCreationTime, const FILETIME *lpLastAccessTime, const FILETIME *lpLastWriteTime)
setsockopt			int (__stdcall *setsockopt)(SOCKET s, int level, int optname, const char *optval, int optlen)
setsockopt			int (__stdcall *setsockopt)(SOCKET s, int level, int optname, const char *optval, int optlen)
ShellExecuteA			HINSTANCE (__stdcall *ShellExecuteA)(HWND hwnd, LPCSTR lpOperation, LPCSTR lpFile, LPCSTR lpParameters, LPCSTR lpDirectory, INT nShowCmd)
SHGetFolderLocation		HRESULT (__stdcall *SHGetFolderLocation)(HWND hwnd, int csidl, HANDLE hToken, DWORD dwFlags, void **ppidl)
SHGetFolderPathW		HRESULT (__stdcall *SHGetFolderPathW)(HWND hwnd, int csidl, HANDLE hToken, DWORD dwFlags, LPWSTR pszPath)
SHGetPathFromIDListW		BOOL (__stdcall *SHGetPathFromIDListW)(const void *pidl, LPWSTR pszPath)
SHFileOperaionA			int (__stdcall *SHFileOperationA)(LPSHFILEOPSTRUCTA lpFileOp)
SHFileOperaionW			int (__stdcall *SHFileOperationW)(LPSHFILEOPSTRUCTW lpFileOp)
shutdown			int (__stdcall *shutdown)(SOCKET s, int how)
Sleep				void (__stdcall *Sleep)(DWORD dwMilliseconds)
socket				SOCKET (__stdcall *socket)(int af, int type, int protocol)
sprintf				int (__cdecl *sprintf)(char *buffer, const char *format, ...)
srand				void (__cdecl *srand)(unsigned int seed)
strcat				char * (__cdecl *strcat)(char *strDestination, const char *strSource)
strchr				char * (__cdecl *strchr)(const char *str, int c)
strcmp				int (__cdecl *strcmp)(const char *string1, const char *string2)
strcpy				char * (__cdecl *strcpy)(char *strDestination, const char *strSource)
strlen				size_t (__cdecl *strlen)(const char *str)
strrchr				char * (__cdecl *strrchr)(const char *str, int c)
strstr				char * (__cdecl *strstr)(const char *str, const char *strSearch)
TerminateProcess		BOOL (__stdcall *TerminateProcess)(HANDLE hProcess, UINT uExitCode)
TerminateThread			BOOL (__stdcall *TerminateThread)(HANDLE hThread, DWORD  dwExitCode)
timeKillEvent			MMRESULT (__stdcall *timeKillEvent)(UINT uTimerID)
timeSetEvent			MMRESULT (__stdcall *timeSetEvent)(UINT uDelay, UINT uResolution, LPTIMECALLBACK lpTimeProc, DWORD_PTR dwUser, UINT fuEvent)
VirtualAlloc			LPVOID (__stdcall *VirtualAlloc)(LPVOID lpAddress, SIZE_T dwSize, DWORD flAllocationType, DWORD flProtect)
VirtualAllocEx			LPVOID (__stdcall *VirtualAllocEx)(HANDLE hProcess, LPVOID lpAddress, SIZE_T dwSize, DWORD flAllocationType, DWORD flProtect)
VirtualFree			BOOL (__stdcall *VirtualFree)(LPVOID lpAddress, SIZE_T dwSize, DWORD dwFreeType)
VirtualFreeEx			BOOL (__stdcall *VirtualFreeEx)(HANDLE hProcess, LPVOID lpAddress, SIZE_T dwSize, DWORD dwFreeType)
WaitForMultipleObjects		DWORD (__stdcall *WaitForMultipleObjects)(DWORD nCount, const HANDLE *lpHandles, BOOL bWaitAll, DWORD dwMilliseconds)
WaitForSingleObject		DWORD (__stdcall *WaitForSingleObject)(HANDLE hHandle, DWORD dwMilliseconds)
wcscmp				int (__cdecl *wcscmp)(const wchar_t *string1, const wchar_t *string2)
WinExec				UINT (__stdcall *WinExec)(LPCSTR lpCmdLine, UINT uCmdShow)
WriteFile			BOOL (__stdcall *WriteFile)(HANDLE hFile, LPCVOID lpBuffer, DWORD nNumberOfBytesToWrite, LPDWORD lpNumberOfBytesWritten, LPOVERLAPPED lpOverlapped)
WriteProcessMemory		BOOL (__stdcall *WriteProcessMemory)(HANDLE hProcess, LPVOID lpBaseAddress, LPCVOID lpBuffer, SIZE_T nSize, SIZE_T *lpNumberOfBytesWritten)
WSACleanup			int (__stdcall *WSACleanup)()
WSAGetLastError			int (__stdcall *WSAGetLastError)()
WSAIoctl			int (__stdcall *WSAIoctl)(SOCKET s, DWORD dwIoControlCode, LPVOID lpvInBuffer, DWORD cbInBuffer, LPVOID lpvOutBuffer, DWORD cbOutBuffer, LPDWORD lpcbBytesReturned, LPWSAOVERLAPPED lpOverlapped, LPWSAOVERLAPPED_COMPLETION_ROUTINE lpCompletionRoutine)
WSAStartup			int (__stdcall *WSAStartup)(WORD wVersionRequired, LPWSADATA lpWSAData)
